1111111111111
1111111111111
1111111111111
1101111111011
1101100011011
1101111111011
1101111111011
1111111111111
1111111111111